R 1920 1080
NO ./textures/wall.xpm
SO ./textures/brick_texture.xpm
WE ./textures/white_texture.xpm
EA ./textures/ivy_texture.xpm

S ./textures/sprite3.xpm
F 220,100,0
C 225,30,0

1111111111
1001000011
1020000001
1100010001
1000010001
10N0010001
1001111001
1000010001
1000010001
1111111111
