1111111111
1001000011
1020000001
1100010001
1000010001
1000010001
1001111001
1000010001
1000010001
1111111111
