R  640 480

NO ./textures/wall.xpm
F 220,100,0  	
SO ./textures/brick_texture.xpm
WE ./textures/white_texture.xpm
EA ./textures/ivy_texture.xpm
S ./textures/sprite3.xpm

C 123,123,123	

10000000000
11111111111111111111111111111110100101
10100000000011111111111111111111111110
10100200000010101000000000101010000000 
1010000000001000000000000000000001010
1010022000000111111 11111111111111111
1010000000000000000000000111111111111
1010000000001111111111111          11
1011111111111000000000              
10000000000011111100N000000         1
1111111111111111111111111111111111111
