R 234 345

NO ./path_to_the_north_texture.x
F 220,100,0  	
SO ./path_to_the_south_texture
WE      	./path_to_the_west_texture
EA ./path_to_the_east_texture
S ./path_to     _the_sprite_texture

C 123,123,123	

10000000000
10111111111111111111111111111110100101
10100000000011111111111111111111111110
10100000000010101000000000101010000000 
1010000000001000000000000000000001010
101000000000111111 11111111111111111
1010000000000000000000000111111111111
1010000000001111111111111          11
1011111111111000000000              1
10000000000011111100N000000         1
1111111111111111111111111111111111111
