R 1920 1080
NO ./textures/redbrick.xpm
SO ./textures/brick_texture.xpm
WE ./textures/wood_1.xpm
EA ./textures/greystone_1.xpm

S ./textures/sprite3.xpm
C 215,215,215
F 40,40,40

 111111               1 11
10000001             101001   111
 1110001    1111     1010001110001
10200001   100201    1000000000201
10001111   100001    1000011100001
100000201110001001111 1201   1001
 11100000000001000000100001110001
100020010N00201000100002000010001
 110000100001110010100111100010001
   1001 1001   1001001    10011011111
   1001 1201    10001     100000000001
   100010001     111       1111111111
   100000001
    1111111
