R 1920 1080
NO ./textures/redbrick.xpm
SO ./textures/brick_texture.xpm
WE ./textures/wood_1.xpm
EA ./textures/greystone_1.xpm
S ./textures/sprite3.xpm
C 255,255,255
F 0,0,0

1111111111111111111111111
1000000000110000000000001
1011000001110000002000001
1001000000000000000000001
111111111011000001110000000000001
100000000011000001111111111111111
11110111111111011100000010001
11110111111111011101010010001
11000000110101011100000010001
10002000000000001100002000001
10000000000000001101010010001
11000001110101011111011110W0111
11110111 1110101 101111010001
11111111 1111111 111111111111