R 640 480
NO ./textures/redbrick.xpm
SO ./textures/brick_texture.xpm
WE ./textures/wood_1.xpm
EA ./textures/greystone_1.xpm

    S ./textures/sprite3.xpm
F 190,150,0
C 230,215,200

1111111111111111111111111111111111111111111111111111111111111
1000000000000000000000000000000000000000000000000000000000001
1010001001110010000001110000001000101000101000101111000111001
1010001010001010000010001000001101101000101100101000101000101
101111101000101000001111100N001010101000101010101000101000101
1010001010001010000010001000001000101000101001101000101000101
1010001001110011111010001000001000100111001000101111000111001
1000000000000000000000000000000000000000000000000000000000001
1111111111111111111111111111111111111111111111111111111111111