R 640 480
NO ./textures/redbrick.xpm
SO ./textures/brick_texture.xpm
WE ./textures/wood_1.xpm
EA ./textures/greystone_1.xpm
S ./textures/sprite3.xpm
SB ./textures/thornbush2.xpm
SC ./textures/greenlight_1.xpm
F 190,150,0
C 230,215,200

111111111111111111111111111111111111111111111111111111111111111
1E0000001000010000100000100100300000301000000000000000000000001
111111031001000100100103100100000300001000000000000000000000001
130000001111010100000100000100111111001000000000000000000000001
111110000000010011111111100100001001001110000000000000000000001
111111111111113000000100100100100101000010000000000000000000001
100000000000011111000001111100100001111010000000000000000000001
100000000000000001111100000000111001001010000000000000000000001
100000000000000000000111110011010011001010000000000000000000001
100000000000000000000000011110011113001010000000000000000000001
100000000000000000000000000000010000000010000000000000000000001
100000000000000000000000000000010031111111110001111110000000001
100000000000000000000000000000010000000000010001000010000000001
100000000000000000000000000000011111111110010001003011000111101
100000000000000000000000000000000001000000011111001001100000101
100000000000000000000000000000000001000011110000000000101110101
100000000000000000000000000000001111001110000011110001001010101
100000000000000000000000000000001001000010001010001001111000001
100000000000000000000000000000001000001000100000101000000000021
111111111111111111111111111111111111111111111111111111111111111
